34 34 Maze-o-morph
XXXXXXXXXXXXXXXXXXXXXXXXXXXXXXXXXXX
X                 X X X X X X X X X
X X X X X X XXXXX X X X X X X X X X
X X X X X X X  *X X X X X X X X X X
X X X X X X X X X X X X X X X X X X
X X X X X X X X X X X X X X X X X X
X X X X X X X X X X X X X X X X X X
X X X X X X X X X X X X X X X X X X
X X X X X X X X X X X X X X X X X X
X X X X X X X X X X X X X X X X X X
X X X X X X X X X X X X X X X X X X
X X X X X X X X X X X X X X X X X X
X XXXXXXXXXXX X X X X X X X X X X X
X             X X X X X X X X X X X
X XXXXXXXXXXXXX X X X X X X X X X X
X               X                 X
XXXXXXXXXXXXXXXXX XXXXXXXXXXXXXXXXX
X0X                               X
X X XXXXXXXXXXXXX XXXXXXXXXXXXXXXXX
X X X                             X
X X X XXXXXXXXXXX XXXXXXXXXXXXXXXXX
X X X X X X X X X                 X
X X X X X X X X X XXXXXXXXXXXXXXXXX
X X X X X X X X X                 X
X X X X X X X X X XXXXXXXXXXXXXXXXX
X X X X X X X X X                 X
X X X X X X X X X XXXXXXXXXXXXXXXXX
X X X X X X X X X                 X
X X X X X X X X X XXXXXXXXXXXXXXXXX
X X X X X X X X X                 X
X X   X X X X X X XXXXXXXXXXXXXXXXX
X XXXXX X X X X X X X X X X X X X X
X                                 X
XXXXXXXXXXXXXXXXXXXXXXXXXXXXXXXXXXX