35 35 Spiral
XXXXXXXXXXXXXXXXXXXXXXXXXXXXXXXXXXX
X                                *X
X XXXXXXXXXXXXXXXXXXXXXXXXXXXXXXXXX
X X                               X
X X XXXXXXXXXXXXXXXXXXXXXXXXXXXXX X
X X X                           X X
X X X XXXXXXXXXXXXXXXXXXXXXXXXX X X
X X X X                       X X X
X X X X XXXXXXXXXXXXXXXXXXXXX X X X
X X X X X                   X X X X
X X X X X XXXXXXXXXXXXXXXXX X X X X
X X X X X X               X X X X X
X X X X X X XXXXXXXXXXXXX X X X X X
X X X X X X X           X X X X X X
X X X X X X X XXXXXXXXX X X X X X X
X X X X X X X X       X X X X X X X
X X X X X X X X XXXXX X X X X X X X
X X X X X X X X X0  X X X X X X X X
X X X X X X X X XXX X X X X X X X X
X X X X X X X X     X X X X X X X X
X X X X X X X XXXXXXX X X X X X X X
X X X X X X X         X X X X X X X
X X X X X X XXXXXXXXXXX X X X X X X
X X X X X X             X X X X X X
X X X X X XXXXXXXXXXXXXXX X X X X X
X X X X X                 X X X X X
X X X X XXXXXXXXXXXXXXXXXXX X X X X
X X X X                     X X X X
X X X XXXXXXXXXXXXXXXXXXXXXXX X X X
X X X                         X X X
X X XXXXXXXXXXXXXXXXXXXXXXXXXXX X X
X X                             X X
X XXXXXXXXXXXXXXXXXXXXXXXXXXXXXXX X
X                                 X
XXXXXXXXXXXXXXXXXXXXXXXXXXXXXXXXXXX