26 26 First Try
XXXXXXXXXXXXXXXXXXXXXXXXX
X                       X
X   0  TTTTTTTTTTTTTT   X
X                       X
X   XXXXXXXXXXXXXXX X   X
X   X               X   X
X   X X          XX:X   X
X   X X          XX X   X
X   X X          XF X   X
X   X XXXXXXXXXXXXF X   X
X   XA          AXF X   X
X   XXXXXXXXXXXX XF X   X
X   XA          AXF X   X
X   X XXXXXXXXXXXXF.X   X
X   XA          AXF X   X
X   XXXXXXXXXXXX XF X   X
X   XA          AXF X   X
X   X XXXXXXXXXXXXF X   X
X   X            XF X   X
X   X XXXXXXXXXXXXF X   X
X   X              *X   X
X   XXXXXXXXXXXXXXXXX   X
X                       X
X                       X
X                       X
XXXXXXXXXXXXXXXXXXXXXXXXX