25 25 First Try
XXXXXXXXXXXXXXXXXXXXXXXXX
X 0                   0 X
X                       X
X                       X
X                       X
X                       X
X                       X
X                       X
X                       X
X                       X
X           +           X
X           *           X
X                       X
X                       X
X                       X
X                       X
X                       X
X                       X
X                       X
X                       X
X                       X
X                       X
X                       X
X 0                   0 X
XXXXXXXXXXXXXXXXXXXXXXXXX