13 5 Round the Corner
XXXXXXXXXXXXX
X 0         X
XXXXXXXXXXX X
X *         X
XXXXXXXXXXXXX
