"minecraft.gfx" 32 32 2012
XXXXXXXXXXXXXXXXXXXXXXXXXXXXXXXX
X          0X  *      X        X
X   XXXXX XXXX   XXXX X XXXXXX X
X X       X X       X   X X    X
X XXXX XX X X XXX XXXXXXX X XXXX
X  X   X  X     X       X   X  X
XX X XXXXXXXXXX XXXX XXXXX XX XX
X        X X    X           X  X
XXXXXXXX X X XXXXXXXXX X XX XX X
X          X      X    X  X    X
X X XXXXXXXXXXX XXXXXXXXX XX XXX
X X     X    X       X  X  X   X
X X X X   XXXX XXXXX XX X XXXX X
X   X XXX  X X X   X X         X
XXXXX X   XX   X XXX XXXXXXXXXXX
X   X   XXX  X X     X  X      X        
X XXXXX X X XX XXXXXXX XX X XX X
X X       X  X            X    X
X   X XXX X XXXXXXXXXXXXXXXXXXXX
XXXXX   X       X    X         X
X   X X XXXXXXX X XX X XXXXXXX X
X XXX X       X X X    X     X X
X   X X       X   XXXXXXX XX X X
XXX   X       XXXXXX      X  X X
X XXXXX       X   XXXXXX XXXXXX
X       X   XX XXX X   X       X
XXX XX XX X  X  X    X X XXXXX X
X XXX   X XXXXX XXXXXX X X     X
X  X  X XXX   X  X   X   X XXXXX
X XXX X X   X XX X X XXXXX X   X
X     X   X X      X         X X
XXXXXXXXXXXXXXXXXXXXXXXXXXXXXXXX
