13 7 Make a Choice
XXXXXXXXXXXXX
X *         X
XXXXXXXXXXX X
X 0         X
XXXXXXXXXXX X
X           X
XXXXXXXXXXXXX
