13 7 Side Passage
XXXXXXXXXXXXX
X *         X
XXXXXX XXXXXX
X 0         X
XXXXXXXXXXX X
X           X
XXXXXXXXXXXXX
