12 7 Loopy
XXXXXXXXXXXX
X 0        X
X ######## X
X      * # X
X ######## X
X          X
XXXXXXXXXXXX
