12 7 Thorny
XXXXXXXXXXXX
X   0    +*X
X XXXXX  + X
X        + X
X XXXXX ++ X
X   +      X
XXXXXXXXXXXX
