13 7 Make a Choice
XXXXXXXXXXXXX
X *         X
XX   XXXXXX X
X       X   X
XXXXXX XXXX X
X 0         X
X           X
XXXXXXXXXXXXX
