"default.gfx" 37 16 COVID-19 1
XXXXXXXXXXXXXXXXXXXXXXXXXXXXXXXXXXXXX
X                                   X
X   0                               X
X             f           f         X
X             f   f     f           X
X          f    f   f  f            X
X         f f f          f f f      X
X      ff           *   f           X
X          ff              f f      X
X     fff f             f    f      X
X            f         f f          X
X        f f    f   f    f          X
X            f  f    f              X
X                                   X
X                                   X
XXXXXXXXXXXXXXXXXXXXXXXXXXXXXXXXXXXXX