201 101 Chris
+++++++++++++++++++++++++++++++++++++++++++++++++++++++++++++++++++++++++++++++++++++++++++++++++++++++++++++++++++++++++++++++++++++++++++++++++++++++++++++++++++++++++++++++++++++++++++++++++++++++++
+0      +   +   +   +         +         +           + +   +     +       +   +   +     +     +         +   +   +     +   +     +   +   +         +     +     +   +                 +   +   +     +       +
+++++++ + + + + + +++ +++++++ +++++ + + +++ +++++++ + + + + +++ + +++++ +++ + + + +++ +++++ + +++++++ + + + + +++++ + + + +++ + + + +++ +++++++ + +++ + +++ + + + +++++++++++ +++ +++ + + + +++++ + +++ +
+   +     +   +   +   +     +   +   + +   +   +   + +   + +   + + +     +   + +   + +     + +   +   +   + + +     + + + +   +   +     + +   +   +   + + +   + + + +         + +       + + +   +   + +   +
+ + +++++++ +++++++ + +++ + +++ + +++ +++ + + + +++ +++++ +++ + + + +++++ +++ +++++ +++ + + +++ + +++++++ + +++++ + + + +++ +++++++++ + + +++ +++++++ + + +++++ + + +++++++++ +++++++++ + +++ + +++ +++ +
+ +       +     +   + +   + +   + +   +   + + +       +   +   + + +   +   +   +     +   + + +   + +     + +   +   + + + + +       +   +   +   +       + + +   + +   +   +   + +     + + +   +   +   +   +
+ +++++ +++++++ + +++ + +++ + +++ + +++ +++ + +++++++ + +++++++ + +++ + +++ +++ + +++ +++++ + +++ + +++ + +++ + +++ + + + +++++++++ +++++++ +++ +++++++ + +++ + + +++ +++ + + + +++ + + + +++++++ +++ +++
+   + +   +       +   + +   + +   +   +   + +   +   +         +   +   +   +     + +   +   + + +   +   +   +   +     + +           + +     + + + +   + + +     +     + +   +   + +     + +   +   +   +   +
+++ + + + +++ +++++ +++ +++++ + +++++++++ + +++++ + +++ +++++ +++ +++++++ +++++++++ +++ + + + + +++++ +++++ +++++++++++++++++++++ + + +++ + + + +++ + + +++++ +++++++ + + +++++ +++ +++ +++ +++ +++ +++ +
+ +   + +   + +   + +         +   +   + + + +     +     +       +   +   +     + +   +   + +   +     +   + +   +         +     +   + +   +   + +             +     +   + + +       +     +     + +   + + +
+ +++++++++ + + + + +++ +++++++++ + + + + + + +++++++++++++++++ +++ +++ +++++ + + + + +++ + +++++++ +++ + +++ + + +++++ + +++ + +++ +++ +++++ +++++ +++++++++++ +++ + + +++ +++++ +++++++++++ + +++++ + +
+     +   +   + +   +   +     +   + + + +   + +       +   +     + +   +   + + +   + + +   +     + +     +   + + +   + + + +   +   + +         +   +     +     +   + +     + +   + +   + +   +           +
+++ + + + +++++ +++++ +++++++ + + + + + + +++ + +++++ + + +++++++ +++ +++ + + + +++ + + +++++++ + +++++ +++ + +++ + + + + +++++++ + + + + +++++++ +++++ + + +++++ + +++++ +++ + + + + + + + +++ +++ + +++
+   +   +     +     +         + + + +   +   +   + +   + + +   +     +     +     +   + + +       +     +   +     + + +   +   +   + + + + + +     + +   +   +     + +   +   +   +   + + +   +     +   +   +
+ +++++++++++ +++++ +++ +++ +++++ + +++++++ +++++ + +++ + + + + +++ + +++ + +++++ +++ + + +++++++++++ +++++++++ + + +++++++ + +++ + + + + + +++ + + + + +++++++ +++++ + +++ +++++++ + +++ +++++++++++++ +
+ +       +   +     + + +   +   +   +     + +     +     + + +     +   +   +     +   + +   +       +       +   + + + +     + +     + + + + +   +     + +   +     +   + +     +   +   + +   +     +       +
+++ +++++ + +++ +++++ + + +++ + + + + + +++ + +++++++++++ + +++ +++++++ +++++ + +++++ +++++ +++++ + +++++ + + + +++ + +++ + + +++++ +++ + +++++++++++ +++ + +++++ + + +++++++ + + + + + +++ + +++ +++++++
+   +     +     +       +     + + +   + +   + + +   +   +     +   +     +     + +   +     + +     + + +   + +   +     + + +       +   + + +       + +     + +     + + +   +   + + + + +   + +   +     + +
+ +++++++++++++++ +++++++++++++++ +++ +++ +++ + + +++ + +++++ +++ + +++++ +++++ + + +++++ + + +++++ + + + + +++++ + +++ + +++ +++ +++ + + + +++++ + + +++++ + +++++ + + + + +++++ + + +++ + +++ +++++ + +
+     +         +   +         +   +   +   +   + +     +       +   +     + +   +   + +   +   +     + + + + +   +   + +   +     + +       + +     + + +   + + +   +   + + +         + +     +   +       + +
+++++ + +++++ +++++ + +++++++ + +++++++ + + +++ +++++++++++ +++ +++++++ + + + +++++ +++ +++ +++++++ + + + +++ + +++ + + +++++++ +++++ +++ +++++ + + +++ + + + +++ + + + +++++++++++++++ +++++++++++++ + +
+   + +     +   + + + +       + +       +   +   +   +       +   +       + + + +   + +       +       +   +   + +   + + +       +     + +   +     + + +   + + +   + + + +     +   +   +   +   +     +   + +
+ + + +++++ +++ + + + +++++ +++ + +++++++++++ +++++ +++++++++ +++ +++++ + + + + + +++ + +++++ +++++++++++++++ +++++ + +++++++++++++ + + +++ +++ + + +++++ + +++ + +++ +++++ + + + + + +++ + + +++ + +++ +
+ +   +   + +   + + +     +   + + + +             + +     + + +   +   + + + +   +   + +     + +   +   + +   +   +   +             +   + +   +   + +   +     +   +   + +     + + + + + +   + +   + +     +
+ +++++ +++ + +++ + + +++ +++ + + + + +++++++ +++ + + +++ + + + +++ + +++ + +++ +++ + +++++ + + + + + + + + +++ + +++++++++++++++ +++++ + +++++ + +++ +++ + + +++++ + + + +++ + + + +++ +++ +++ +++++++ +
+     +     +   + +   +   +   + +   +     + + +   +     + +   +   + +     + +   +   + +   +     + + +     +   + + +   +   +       +     + +   + +   +   + + + +   +   + + +   + + +     +   + +   +     +
+++++ +++++ +++ + +++++++++ +++ +++ +++++ + + + + +++++ +++ + +++ + +++++++ +++++ +++ +++ +++++++ + +++++++++ + + + + + + + +++++++ +++++++ + +++++ +++ +++ + + + +++++ + + +++ + +++++++ +++ +++ +++++ +
+ +       + +   +       + + +   +   +     +   + +     +     + +   + +     + +   +   +   + +       +         +   + + + + +   +   +   +       + +     +       + + +   +   +   +   +   +     +   + +   +   +
+ + +++++ + + +++++++++ + + + +++ +++ +++++++++ +++++ +++ +++++ +++ + + + + + + +++ + + + + +++++++++++++++ +++++ +++ +++++ + + + +++ +++++++ + +++++++ +++++ +++++ + +++++++ +++++ + + +++++ + +++ + +++
+ +     +   +   +         +   +   +   +   +   +   +   + + +   +   + + + + + + +     + +   +     +     +     +   + +     +   + + + +   +     +   +           +     +   +     +     + + + +     +   + +   +
+ +++++ +++++++++ +++++ + +++++ +++ +++ + +++ +++++ +++ + + + +++ + +++ + +++ +++ +++ +++++++++ + +++ +++++ + +++ + + + + +++++ + + + + +++ +++++++ +++++++++++++ +++++ +++ + +++++ + + +++ +++ + + +++++
+ +             +     + +   +     +   + +         +       + +   +   +   + +     + +   +   + +   + + +   +   +   +   + + + +     + + + + + +         +   +   +   +   +     + + +   + + +     +   + + +   +
+ + +++++++++++ +++++ + +++ + +++ +++ +++++++++++ +++++ +++++++ +++++ +++++ +++ +++ +++ + + + +++ + + + + +++++ +++++++ + + +++++ + +++ + +++ +++++++++ + + + + +++ +++++ + + + + + + +++++++ +++ + + + +
+   +   +     +       + + +   +   +   +         +     + +     + +   +   +   + +       + + + + + +   + + +     +     +   + + +     +   + + + +   +   +   + + + +   + +   + +   + + + +     +   +   +   + +
+ +++ + + +++ +++++++++ + +++++ +++++++ + +++++ +++ +++ + +++ + + +++++ + +++ + +++++++ + + + + +++++ + +++++ +++++ + +++ + +++++ +++ + + + +++ +++ + +++ +++ +++ + + + + +++++ + + +++++ + +++ +++++++ +
+ + + + + +   + +   +   + +   +     +   + +   +     +   +   +   +       + + +   +     + + +   +     + +   + +   +   + +   + +   +     + +   +   +   + +     +   + +   + +       +   +     + +       +   +
+ + + + + + +++ + + +++ + +++ +++++ + +++ +++ +++++++ +++++ +++ + +++ +++ + +++++ +++ + + + +++++++ + +++ + +++ +++ + + +++ + + +++++++ +++ + +++ +++ + +++ +++ + +++++ +++++++++++++ +++++ +++++++ +++ +
+ + + + + +     + + +   +   + +   +   +   +   + +   +         + + + +     +   + + + + + +   +   +   + +   +       + + + +   + + +   + + +   +         + + +   + +   +     +           +     +   +     + +
+ + + + + +++++ + + + +++++ + + + +++++ +++ +++ + + +++++++ + +++ + +++ +++++ + + + + + +++++ + + +++ + +++++++ + + + + + +++++ + + + + + +++++++++++++ + + + + +++ +++++ + +++++++++++++++++ + +++++ + +
+ +   + + +   +   +   +   +     +   +   + +       +       + +     + +   +   +   + + + +     + + + +   + +       +   + +       + + + + + + +       +   +   + + + +   +   + + +     +   +   + + +       + +
+ +++++ + + + +++++++++ +++++ +++++++ +++ +++++ +++ +++++ + +++++++ +++++ + + + + + + +++++ + + + +++++ + + +++++++++ +++ +++ + +++ + + + + +++++ + +++++++ + + + +++ + + +++ +++ + + + + + + +++++ +++ +
+   +   +   + +       +       +     +   + +       +   +   + +   +   +   + + + +     +   +     +   +     + + +   +     +   +   +   + + + + +     + +     +   + + +     + +   + + +   +   + +   +     +   +
+++ + +++++++ + +++++ +++++++ + +++ + + + + +++ XXXXX XXXXX X X X XXX X XXX +++++ XXXXX + + +++++++ +++++++ +++ + XXXXXXXXX XXXXX X X X X XXXXX + +++++ + +++ + +++++++ +++ + + +++++++++ +++++ +++++ +++
+   + +     + +     + +   + +     +   + + +   + X           X X   X   X     +     X   X + + +       +   +   +   + X     X   X   X X X X X     X + +   +   +   + +   +     + +   +   +         +   +     +
+ +++ + +++ + +++ +++ + + + +++ + +++++++ +++ ++X XXX XXX XXX X X X XXX XXX++ ++++X XXX +++ + +++++++++ + + + +++ X XXX X XXX X X X X X XXXXX X + +++ +++ + +++ + + + + +++ +++++++ +++++++++ +++ +++++ +
+ + + +   +     +   +   + + +   +       + +   +   X   +   +   + + +   + +   +   + X   X   + +       +   + +       X X   + +   + + +   +     + + +     +   +   + + + + +   + +     +       + + +   +   + +
+ + + + +++++++++++ +++++ + +++++++++++ + +++++ XXX +++ +++++++ +++++++ + +++++ + XXX X + + +++++++ + +++ +++ ++++X X X++ + +++ + +++ +++ +++ + + +++++ +++++ + + + +++++ + + +++ +++++++ + + + +++ + + +
+ +   +   +   +     +   +   +   +     + +     + X X +   +     + +       +             X + +     +   +   +   +     X X X   +   +   +     + +   + + +   +     + + + +     +   + + +   +   + +   + +   + + +
+ + +++++ +++ + +++++++ +++++ + + +++ + +++ +++ X X + +++ + + + + +++++++++++++ ++XXXXX++ +++++ + +++++ +++ +++ + X X X +++++ +++++ +++ + + + +++ + + +++++ + +++ +++++ + +++ + +++ + + + + +++ + +++ + +
+ + +     +   +   +   + +     +   + +   +   +   X X +     + +   +   +   +     +     X   + +   + +   +   +   +   + X X X     +   +   +   + + +   + + + +   + +   +   + + + +   +     + +   + + + + +   + +
+ + +++ +++ +++++ + + + + + +++++++ + +++ +++ +XX X +++++++++++++++ +++ +++ ++++++X X X + + + +++++ +++ +++++ +++ X X X++++ +++ + +++ +++ + +++ + + +++ + +++++ +++ + + + + +++ +++++++ +++ + + + + +++ +
+ +   +     +   +   +   + + +     + +   +     +   X +     +       +       +   +       X + + + +   +   +   + + +   X X     X     X X   X   X   X   +   + +     +   + +   +   +         +   + + + + +     +
+ +++ +++++++ + +++ +++++++ +++ + + +++++++++++ XXX + +++ + +++ + +++++ + +++ +++ XXXXX++ + + + + +++ +++ + + + ++X XXXXX XXX XXX X XXX XXXXX X++++ + + +++++ + +++ +++++ + + +++++++ +++ + + + + +++++++
+ +   +   + + + +   +     + +   + + + +     +       +   +   +   +   +   + + +     X X   + + + + +     +     + + +   X   X X       X X   X   X X   + + + +     +   +       + +   +     +   + + + + +   + +
+ + +++++ + + + + + + +++ + + +++ + + + +++ +++XX X++++ +++++ +++++ +++++ + ++++++X X X + + + + +++++++ +++++ + + +++ +++ +++ +++++ + +++ X X X + + + + + +++++++ +++ +++++++++ + +++++ +++ + + + +++ + +
+         +   +   + +   + + + +   +   + + +       +   + +     +     +     +   +     X X     + +       + +   + +   +   +   +   +   + + +   X   X + + + + +     +       +   +   + +     + +   +   +   + + +
+++ +++++++++ +++++ +++ + + +++ +++ + + + +++++XXXX + + + +++++ +++++ +++++++ + ++XXX X++++++++ +++++++ + + + +++++ +++ +++ +++++ + + + ++X XXX + + + + +++ + + + +++++ + + + +++++++ + + +++++ +++ + + +
+   +     +   +   +     + + +   + + + +         X   +   +   +   +   + +   +       X X   +       +         +   +   + + + +         + + +   X X   + + +   +   +   +       +   + +     +     +     +   + + +
+ +++++ +++ +++ +++++ +++ + + +++ + + +++ +++++ XXX++ +++++ + +++ + + +++ +++++ + X XXX + +++++ + +++++++++++++ + + + + + +++++++++ + +++ X X X++ + +++++ +++++ +++++++++++++ + +++ + +++++ +++++ + + + +
+     +   +   +     + +   + + +   + +   + +     X     + +   + +   + +   +       +     X +   +   + +   +     +   + + + + + +   +   +   +   X   X     +     +   + +   + +       + + + +           + + + + +
+++++ +++ +++ +++++ + +++ + + + +++ +++++ +++++ X XXXXX X XXX X XXX X X XXX++ ++++X XXX XXX X XXX XXX X XXX X ++++X X X X X X X X XXXXXXXXX XXX++++++ +++++ + +++ + + + +++++ + + + +++++++ +++ + + + + +
+   +   +       +   +   + +   + +     +   +   +   X   X X X X   X X   X     +     X X   X   X   X         X X +     X   X   X X X X         X   +   + +     +   + +   +     + +   +         +     +   + +
+ +++ + +++++++++ +++++ + +++ + + +++ + +++ + +XXXX X X X X XXX X X XXX XXX++++++ X X XXX XXXXXXXXXXXXXXXXX X + + XXX XXX XXX X X X XXXXXXXXX X +++ + + +++++++ + +++++++++ + +++++++++++++++++++++++++ +
+   + + +       +     + +   + + +   +   +   +     + +     +     +   + + +     +   + + +   +             +   + + + +       +   + +   +       + +     + + +     +     +   + + +   +   +       +     +     +
+++ + + +++++++ + +++ +++++ +++ +++ +++++ +++++++ + +++++++ +++++++++ + + +++ +++++ + + +++ +++++++++++ + +++ + + +++ +++++ +++ +++++ +++++ + +++ +++ + + +++ +++ + + + + + +++ + + + +++++ + +++ + +++++
+   + + +   +   + +   +     +   +   +   + +     + +       +     +     +   +   +   +   + + + +   +     +   + + + +     +   + +   +   +     +   +   +   +     +   + + + + +   +     + +   + + + +   +     +
+ +++ + + + + +++ + +++ +++++ +++ +++ + + +++++ X X XXXXX XXXXXXX XXXXXXXXX +++ + X XXX X X X X X XXX XXXXX X ++++XXXXX X X X XXXXX XXXXX XXXXX +++++ +++++++++ +++ +++ +++ +++++++ +++ + + + + +++++++ +
+ +   + + + + +   +       +     +   + + +   + +   X     X X   X   X     X   +   +   X     X X X X X X       X           X   X         X X     X +     + +     +   +   +   + +   +     +   +   + + +   + +
+ +++++ + + + + +++++++ + +++ + + + + +++++ + ++XXXXXXXXX X X X XXXXX X X X++ ++++XXX X X X X X X X XXX XXXXX+++++XXXXXXXXXXX X XXXXX X XXXXX X + +++++ + +++ +++ +++ +++ + + + +++++ +++++++++ + + + + +
+   + +   +     + +     +   + + + +   +     +           + + +   + +   +   X   +       + +   + + + +   +     X         +   +   X X   +     + + + + +   + +   + + +   +       + +     + +         +   + + +
+++ + +++++ +++++ + +++++++ + + + +++++ ++++++++XXXX+++ + + +++++ + ++++++XXX +++ XXXX+ + +++++ + +++ ++++X X +++++++ + + + +XX X +++++ + + + +++ +++ + +++ + + +++ +++++++++ +++++ + + +++ +++++++++ + +
+     +     +   + + +       + + + +     +   +         +   +   +   +         X   +     + +   +   + +   +     X   +       +   +   X     + + + +     +   + + + + + + + +     +     +   +   +   +   +     + +
+ + +++ +++++ +++ + + +++++++++ + + +++++ + +++ XXX + +++++++ + + ++++++++X X++ ++XXXX+ +++ + +++ + +++ ++XXX++++ +++ +++++++ XXXX+++ +++ + +++++++ + + + + + + + + + +++ + + + +++++++++++++ + + +++++ +
+ + +     +   +   + +     +   + + +     + +   + X   +   +   +   +         X X           +   + +   + + + +     +   +   +             +     +       + + + + + +   +       + + + +   +   +   +   + +     + +
+ + + +++ + +++ +++ +++++ +++ + + +++++ + +++ ++X XX+++ +++ +++++++++++ + X X + ++XXXX+++ +++ + +++ + + ++XXX + +++ +++++++++XX XX+ +++++ +++++ + + +++ + + +++++++++++++ + +++++ +++ + + + +++ +++++ + +
+ + + +   +   + +   +   +     + +   +   + +   +   X   X X     X X     X X   + + +     +   +   +     +   +     +   +     +   +   X   +     +   + + +   + +         +     + +   + +     + + +   + +   +   +
+ +++ +++++++ + + + + + +++++++ +++ +++ + + +++ XXX X X X XXX X X XXXXX XX+++++ + XXXX+ +++ +++++++++++ + XXX +++ +++++ + + +XXXXX+++ +++++ + + + +++ + +++++++++ + +++ + +++ + + +++++ + + + + +++ +++ +
+   + +   + + +   + + + +     +   +     + +   +   X X X X   X   X   X   X       +   X   +   +         +   X     +     + + +         + +   + + + +   + +     + +   +   + +     +   +     +   + + +     + +
+++ + + + + + +++++ + + +++++ +++ +++++++ +++ + XXX + + +++ +++ + +++ +++ XXX+++++X X +++ +++ +++ +++ ++++X X++ +++++++ +++++XXXXX+ +++ + + + + +++ + +++++ + + +++++ +++++++ + +++ +++++++++++ + +++ + +
+   +   + + +     +   + +     +       +     + +     + +   +   + +   +             X X     +   +   +   +   X   + +     +     +   X +   + + + +   + +   +   +     +   + +       + +   +   +       +   + + +
+ +++++++ + +++++ +++++ + +++++ +++++ +++++++ + XXXX+++++ +++++ +++ ++++++X X+++++X X +++++ +++ +++++++ + XXX + + +++ +++ +++ X X + + +++ + +++ + +++++ +++++ + + + + + +++++++ + +++ + + +++++++++ + + +
+     +   +     + + +   +   +   +     +       + X   +   +     +   +         X     X X   +   +   +     + +   X +   + + +   +   X   + + +   +   + + +   +     + + + +   + +       + +   + + +       + +   +
+ +++ + +++ + + + + + +++++ + +++ +++++ ++++++++X X + +++ +++ +++ ++++++++XXX +++ X XX+ + +++ +++ +++ + + X X +++++ + + + + +XXXXX+++ + +++ + + + + + +++++ + + + +++++ + +++++++++ +++ + + +++++ + +++++
+   +   +   + +   +   +     + +   +     +   +   X X +   + + + +   +         X + + X     + +   +   +     + X   +   +     + + +         +   + + + + + + +   +   + +   +   + +   +     +   + +     +   +   +
+++ +++++ +++++++++++++++ +++ + +++ + +++++ + + X X XXX X X X X XXX XXXXXXX X + + XXX +++ + +++++++ + ++++XXXX+++ +++ +++++ + XXXX+++++++ +++ +++ + + + + + +++++++ + +++ + + + +++++ +++ +++++ + +++ + +
+ +   +   +   +   +     + +   +     + +   +   +   X   X   X X X   X       X + + +   X X X X         X X     X   +     + +   + X   +   + +   +       + + + + +       +   +   + + +   +       + + + +   + +
+ +++ + +++++ + + + +++ + + +++ +++ + +++ + ++++XXXXXXXXXXX X XXX XXXXXXXX+ + + ++X X X X XXXXXXXXXXXXX XXX X + + +++++ + +++ X X + + + +++ +++++ +++++ + + + +++ +++++ +++++ + + + + +++ + + + + + +++++
+       +   +   + +   +   +   +   + +   + + +     X         X   X   X       +   +     + +     +   +   +   + + + +   +     +     +   + +   + +   +       +   + + +       +   +   + +   +   + +   + + +   +
+++++ +++++ +++++ + + +++++++ +++ + +++ + + + +++ + +++++ +++++ +++ +++ +++++++++ + +++ +++++ + + + + +++ + + +++ + + +++++ + +++++++ +++ + +++ +++++++++ +++ + +++++++++ + +++++ +++++ +++ +++++ + + + +
+   +     +     + + + +       +   + + +   +   + +       +   +   +     + +   +     + +     +     + + + +   + +     +   +     + +       +   + +   +       +   + + +         + +     +     + +     + +   + +
+ +++++++ +++ + + + + + +++++++ +++ + +++++ +++ + +++++++++ + +++ + + + +++ + +++++ + +++ + +++++ + + + +++ +++++++++++++++++ + +++++++ +++ + +++++++++ + + + + + +++++++ +++ +++++ +++++ +++++ + +++++ +
+ +       +   + + + +     +   + +   +   +   + + +   +         +   + +     +   +     +   +   +     + + +   +     +         +   +         +   +   +         + +   + + +         +     +           +     + +
+ + +++++++ +++++ +++++ + + + + + +++ + + + + + +++++ +++++ +++ +++ +++++ +++++ +++++++++ +++ +++++ + +++++++++ + +++++++ + +++++++++++++ +++++ + +++++ +++++++++ + + +++++++++ + +++ +++++++++++ +++ + +
+ +   +         + +     +   + + +     + + + + +       +     +   +   +     +       +   +   +   +   + +   +     + +       +   +   +       + +       +     +     +   +   +   +     +   +             + + + +
+ +++ + + + +++ + + +++++++++ + +++++++ + + + +++++++++++ +++ +++ +++ +++++ +++++++ + + +++ +++ + +++ + + + +++ +++++++++ +++ + + + +++++ + +++ +++ +++++++++ + +++++++ +++ +++ +++ +++++++++++++++ + + +
+ + +   + + + +     + +       +       + + + + +           +   + +   + +   +   +     +   +   +   +     +   +   +   +   +   +   +   +   +   + +   +   +   +     + +   +   +   + +   +       +   +     + + +
+ + +++++++ + +++ +++ + +++++++ + +++++ + + + + +++++++++++++ + +++ + + + +++ + +++++++++++ + +++++ +++++++ + +++ + + + +++ +++++++ +++ + +++ +++ +++ + + +++++ + + + +++ +++ +++++ +++++ +++ + +++++ + +
+           +     + +   +       +     + + + +   +           + +     +   + + + +       +     + + +       + + + +     +   + + +     + +   +   +   + +   + + +     + +   + + +       + +   +     +       + +
+++++++++++++ +++++ +++++ + +++++++++ +++ + +++++++++ +++++ + +++++++++++ + + +++++++ + +++++ + + +++++ + + +++ + +++++++ + + +++ + + +++++ + + + +++++ + + +++++ + +++ + +++++++ + + + +++++++ +++++++ +
+                 +       +         +     +           +       +           +           +       +   +     +       +             +   +   +       + +         +       +     +         +   +       +        *+ 
+++++++++++++++++++++++++++++++++++++++++++++++++++++++++++++++++++++++++++++++++++++++++++++++++++++++++++++++++++++++++++++++++++++++++++++++++++++++++++++++++++++++++++++++++++++++++++++++++++++++++