35 35 Spiral
XXXXXXXXXXXXXXXXXXXXXXXXXXXXXXXXXXX
X                                0X
X                                 X
X                                 X
X                                 X
X                                 X
X                                 X
X                                 X
X                                 X
X                                 X
X                                 X
X                                 X
X                                 X
X                                 X
X                                 X
X                                 X
X                                 X
X                                 X
X                                 X
X                                 X
X                                 X
X                                 X
X     X  XX                       X
X     X  *X                       X
X     XXXXX                       X
X                                 X
X                                 X
X                                 X
X                                 X
X                                 X
X                                 X
X                                 X
X                                 X
X                                 X
XXXXXXXXXXXXXXXXXXXXXXXXXXXXXXXXXXX