30 27 Hyperion Astra
XXXXXXXXXXXXXXXXXXXXXXXXXXXXXX
X  #      #        # # # # # X
X# ## # #   #### # #   #   # X
X     #   ##     #   #   #   X
X###*#####  ######## ######XXX
X   #    #        #  # # #   X
X        # ###### # ##   X X X
X        #   # #  #  # #XX   X
X        ### # # ### #   X X X
X        #         #   X X   X
X#### # ########## XXX X X X X
X   #  #     #   #   X   X   X
X # #    # # # # XXX XXX X X X
X ######## #   X X   X   X   X
X #     # ## # X X XXX XXX X X
X # ###          X       X   X
X     # # #XXXXXXXXXXXX XX X X
X#### ### X              X   X
X #   #   X XX XXXXXXXXX X X X
X # #   X X X XX   X   XXX X X
X # #XXXXXX X  XXX   X       X
X #                X   X X0X X
X #XXXXXXXXXXXXXXXXXXXXXXXXX X
X               X     X      X
X #XX X X XXXXX XX XX XX XXX X
X            X     X     X   X
XXXXXXXXXXXXXXXXXXXXXXXXXXXXXX
