30 32 Ms. Pac-Man

 ############################ 
 #      ##          ##      # 
 # #### ## ######## ## ####*#
 # #### ## ######## ## #### #
 #                          #
 ### ## ##### ## ##### ## ###
 XX# ## ##### ## ##### ## #XX
#### ## ##### ## ##### ## ####
     ##       ##       ##
#### ##### ######## ##### ####
 XX#                      #XX
 XX# ##### ###  ### ##### #XX
 XX# ##### #      # ##### #XX
 XX# ##    #      #    ## #XX
 XX# ## ## #      # ## ## #XX
#### ## ## ######## ## ## ####
         
#### ######## ## ######## ####
 XX# ######## ## ######## #XX
 XX#          ##          #XX
 XX# ##### ######## ##### #XX
 ### ##### ######## ##### ###
 #                          #
 # #### ##### ## ##### #### #
 # #### ##### ## ##### #### #
 # #### ##    ##    ## #### #
 #0#### ## ######## ## #### #
 # #### ## ######## ## #### #
 #                          #
 ############################ 
