"default.gfx" 47 47 QR

                                             
                                             
   XXXXXXX   X XX  XX XX   X X XXX   XXXXXXX  
   X     X   XX XXX X  X XXXXX   X X X     X  
   X XXX X      XX     XXXXX XXXXX X X XXX X  
   X XXX X XX  X XXX X   XX  X XXX   X XXX X  
   X XXX X  X       X  X    XX  XX   X XXX X  
   X     X X XX X X  XX  XX  X XXX X X       
   XXXXX X X X X X X X X X X X X X X XXXXXXX  
           XXX X XXXX XX     XXX X X          
    XX   X   X X X   X XXXX  XXX  X  XX X     
       X       X X    X XXX   XX XXXXXX  XXX  
   XX XX XXXXXX  XX XXXX    X X X X XXX XXXX  
    X  XX XX X XX XXX X   X  XX   XXX   X     
   X X XXX XXXX   XXX XXXXXX  X   X XX    X   
     XXXX X X X   X X X    XXX  XXXXXXX XX X  
   XXX   X X  XXXX X XX X  X  X XXXXX  X X X  
    X  XX XXX  X XXXX XXXXXX X   X   X  X XX  
    XXXXXXX X  XX XXXXX       X    XXX        
   XX XX  XX X XXX X XX XXX   X XXXX X     X  
   XXX  XX  X XXX* X  XXX X XXX X X  XXX  XX  
    XX X  X X X X   X  XXXX  X   XXX    X XX  
     XX  X XX  XXXX    X XXXXX0X   X X  X     
     X  X  X X XX  XX X XXXXXXXX  XX X     X  
   X   X X  XX XX       XXXX  XX  XXXXXXXX X  
   XX     X X  X X  XXX  XX   XX XXXXX XX XX  
     X  XXX X X X XXX   X XX     X   X  XXXX  
    XXXXX       X     X X XX  XX  XX XX X XX  
   X  XXXXX XX X    XXX   XX XX X X  X XXXXX  
       X      XX X X  X  X    X  XXX  X X  X  
   X XXXXX X  X XX XXXXXX     XX X XXXX    X  
    XXX      XX X   XX X       X  XX XX    X  
   XXX  XXXX X XX    X  XXX  X X XXX  XX  XX  
      X X XX       XXXXX X   XXX XXXXXX X X   
   XXXX  X XXX   XX X    XX      X XXXXX  X   
           X  XX XXX  X XXXXX X XX X   XXX X  
   XXXXXXX   X  X   XX    X   XXX  X X X   X  
   X     X  X  XXX    XX    X XX   X   XX X   
   X XXX X  X  XXXX    X X  X X XXXXXXXX  X   
   X XXX X   XX   X   XXX XXX XXX X   XX      
   X XXX X XX X    XXXX XXX   X    XX  X   X  
   X     X XXX XX X  XX XX   XXX   XX   X     
   XXX XXX   X X  X  X  X XX   X  XX X XX  X  
 
                                            
                                             
