5 5 Test
XXXXX
X0  X
X   X
X  0X
XXXXX