33 28 Team Central
XXXXXXXXXXXXXXXXXXXXXXXXXXXXXXXXX
X XX   X   X    XX    X       X X
X    X   X X  X     X X XXXX  X X
XXXX XXXXX X XXXXXXXX     X     X
XX         X           XX X X X X
X   X X  X X XX XXXXXX  X X XXX X
X X  X  X  X X        X X X   XXX
X  X X X  X  X XXXX X X X  XX X X
X      X X   X    XXXX  X   X   X
XXX X  X    X X 0   X     X X X X
X   X XXXXXXX XXXXX X XXXXXXXXX X
X X                 X       X X X
X X X X XXXXXXX 0 XXXXXXXXX X X X
X   X X                     X   X
XXXXX XXX X X XXXXX XXXXXX  X   X
X           X  X X  X    XX X XXX
X XXX XXXXXXX X * X X    X  X   X
X   X X        X X  X XX XX XX XX
X X X X XX   X X X X   X X  X   X
X X      X XXXXX X XXX X X X  X X
X X X XX X X     X   X X X  X X X
X   X X  X X XXX XXX X X XXXX X X
XXXXX X XX X   X X   X X X      X
X     X X  XXXXX XXXXX X X XXXX X
X XXXXX  X X X       X   X X    X
X X   X XX X X XXXXXXXXXX  X X  X
X     X    X              X     X
XXXXXXXXXXXXXXXXXXXXXXXXXXXXXXXXX
