21 21 Gladiator Arena (4 player)
%%%%%%%%%%%%%%%%%%%%%
%%%%%%%%     %%%%%%%%    
%%%%%  s        %%%%%
%%%%   0     1   %%%%
%%%  0         1  %%%
%%  0           1 s%%
%%     .......     %%
%%                 %%
%   ...   e   ...   %
%   ...       ...   %
%   .e. e e e .e.   %
%   ...       ...   %
%   ...   e   ...   %
%%                 %%
%%     .......     %%
%%s 2           3  %%
%%%  2         3  %%%
%%%%   2     3   %%%%  
%%%%%        s  %%%%%
%%%%%%%%     %%%%%%%%
%%%%%%%%%%%%%%%%%%%%%
