21 21 Gladiator Arena
%%%%%%%%%%%%%%%%%%%%%
%%%%%%%%     %%%%%%%%    
%%%%%           %%%%%
%%%%             %%%%
%%%               %%%
%%                 %%
%%        0        %%
%%                 %%
%    0         1    %
%                   %
%    0         1    %
%                   %
%    0         1    %
%%                 %%
%%        1        %%
%%                 %%
%%%               %%%
%%%%             %%%%  
%%%%%           %%%%%
%%%%%%%%     %%%%%%%%
%%%%%%%%%%%%%%%%%%%%%
