"minecraft.gfx" 5 10 Chokepoint
XXXXX
X000X
X000X
XX0XX
XX0XX
XX1XX
XX1XX
X111X
X111X
XXXXX

