28 25 Courts of Chaos
XXXXXXXXXXXXXXXXXXXXXXXXXXXX
XX0  X X X0X               X
X0 0        X              X
XX  0       XXXXXXXXXXXXXXXX
X    0       X        XaaaaX
X     0+     X XXX X  Xaa aX
X     +0     X   X X   aaaaX
XX     +0    XXXXX XXXXXXX X
X X      0   X        X    X
X X       0  X X XXXX X XXXX
XX  +  ++    X X X    X    X
X   +          XXXXX  X XX X
X ++ ++  +++++ X   X  X X  X
X   +          X X   X  XX X
XX  +  ++    X   X X XX X  X
X X       1  X X   X       X
X X      1   X   X X X XXX X
XX     +1    XXXXX X X     X
X     +1     X     X   XXXXX
X     1+     X XXX XX XXfffX
X    1       X+    X    fffX
XX  1       XXXXXXXXXXXXXXXX
X1 1        X              X
XX1  X X X1X               X
XXXXXXXXXXXXXXXXXXXXXXXXXXXX

