20 29 Double Time
XXXXXXXXXXXXXXXXXXXX
X     #            X
X     #        000 X
X     #   0    0   X
X 000 #        000 X
X     #            X
X     #            X
X ##  #            X
X     #            X
X + + + + +       XX
X +   #         X XX
X + + +++ +     X XX
X  fff#   +     X XX
X + +++ + +     X  X
X               X  X
X + +++ + +     X  X
X  fff#   +     X XX
X + + +++ +     X XX
X +   #         X XX
X + + + + +       XX
X     #            X
X ##  #            X
X     #            X
X     #            X
X 111 #        111 X
X     #   1    1   X
X     #        111 X
X     #            X
XXXXXXXXXXXXXXXXXXXX
