"default.gfx" 29 29 Faceoff!
XXXXXXXXXXXXXXXXXXXXXXXXXXXXX
XX X X X X X X X X X X X X XX
X                           X 
XX XXXXX                   XX
X  X 1 X            X 1 X   X
XX X 1               XXX   XX
X    1 X                    X
XX X 11X      1       1    XX
X  XXXXX                    X
XX     1        XXXX       XX
X                           X
XX                         XX 
XXXXXX+XXXX+X X+X XXXXX XX XX
XX          a a a          XX
X          a a+a a          X
XX          a a a     +    XX
XX XX XXXXX X+X X+XXXX+XXXXXX
XX                         XX
X                           X
XX        XXXX       0     XX
X                    XXXXX  X
XX     0       0     X00 X XX
X                    X 0    X 
XX    XXX              0 X XX
X    X 0 X           X 0 X  X 
XX                   XXXXX XX
X                           X 
XX X X X X X X X X X X X X XX
XXXXXXXXXXXXXXXXXXXXXXXXXXXXX
