12 15 The Gauntlet
XXXXXXXXXXXX
X    00000 X
X  #     0 X
XX #### ###X
X  #  # #  X
X ## ff ff X
X  # ff ff X
XX ffff ff X
X  # ff ff X
X ## ff ff X
X  #  # #  X
XX #### ###X
X  #     1 X
X    11111 X
XXXXXXXXXXXX
