15 25 Harvester of Sorrow
XXXXXXXXXXXXXXX
X         f   X
X1X1 1X1 1+1 1X
X X    +  +   X
X X    ++++   X
X X    a      X
X +++++X      X
X      Xff++++X
X+     X  aaa+X
X+++++f+f+++++X
XXXXXX X XXXXXX
X     a a     X
X2 2 2 2 2 2 2X
X     a a     X
XXXXXX X XXXXXX
X+++++f+f+++++X
X+aaa  X     +X
X++++ffX      X
X      X+++++ X
X      a    X X
X   ++++    X X
X   +  +    X X
X0 0+0 0X0 0X0X
X   f         X
XXXXXXXXXXXXXXX

