"default.gfx" 21 23 Pathfinding

 ################### 
 #        #      #0#
 # ## ### # ### ####
 #                 #
 # ## # ##### # ## #
 #    #   #   #    #
 #### ### # ### ####
    # #       # #
##### # ## ## # #####
 +      #   # #    +
##### # ##### # #####
    # #       # #
 #### # ##### # ####
 #        #        #
 # ## ### # ### ## #
 #  #           #  #
 ## # # ##### # # ##
 #    #   #   #    #
 # ###### # ###### #
 #       1         #
 ###################
