28 25 Tanhauser Gate
XXXXXXXXXXXXXXXXXXXXXXXXXXXX
X     0 0          00      X
X                          X
XX    0    XXXXXXXXXXXXXXXXX
X            X          aaa%
X            X XXX %% %%aaa%
X     0 0    X     %   %%%%%
XX  ++++++   XXXXX % X     X
X            X1  % % X XXX X
X            # %   %       X
XX  +++++X   % % %   X  #  X
X   +ffffX     % %   X  #  X
X             +  %  +X  #  X
X   +ffffX     % %   X  #  X
XX  +++++X   % % %   X  #  X
X            # %   %       X
X            X0  % % X XXX X
XX  ++++++   XXXXX % X     X
X     1 1    X     %   %%%%%
X            X XXX %% %%aaa%
X            X          aaa%
XX    1    XXXXXXXXXXXXXXXXX
X                  11      X
X     1 1                  X
XXXXXXXXXXXXXXXXXXXXXXXXXXXX

