"minecraft.gfx" 21 21 Tunnel
%%%%%%%%%%%%%%%%%%%%%
%                   %
% %%%%%%%%%%%%%%%%% %
% %  1 1 1 1 1 1  % %
% %  11111111111    %
% %  1         1  %%%
% %                 %
% %      f      f   %
% %       %%      % %
% %   f aaaaaa f  % % 
%      aaaaaaaa   # #
# #   f aaaaaa f  # #
# #       ##      # # 
# #  f      f       # 
# #                 #
# #  0         0  ###
# #  00000000000    #   
# #  0 0 0 0 0 0  # #
# ################# #
#                   #
#####################
